WWWWWWWWWWWWWWWWW
W               W
W               W
W               W
W  $    H       W
W               W
W      M        W
W               W
WWWWWWWWWWWWWWWWW